*******************
*-----------------*
*-----------------*
*-----------------*
*----------------->
*-----------------*
*-----------------*
*-----------------*
*-----------------*
*********v*********
