*******************
*-----------------*
*-----------------*
*-----------------*
<-----------------*
*-----------------*
*-----------------*
*-----------------*
*-----------------*
*********v*********
