*********^*********
*-----------------*
*-----------------*
*-----------------*
*----------------->
*-----------------*
*-----------------*
*-----------------*
*-----------------*
*******************
