*********^*********
*-----------------*
*-----------------*
*-----------------*
<-----------------*
*-----------------*
*-----------------*
*-----------------*
*-----------------*
*******************
